b b b b b b b b b b b b b b b b b b b b b b b b b 
b x x x x x x x x x x x x x x x x x x x x x x d b 
b x x x x x x x x x x x x x x x x x x x x x x x b 
b x x x x x x x x x x x x x x x x x x x x x x x b 
b x x x x x x x x x x x x x x x x x x x x x x x b 
b x x x x x x x x x x x x x x x x x x x x x x x b 
b x x x x x x x x x x x x x x x x x x x x x x x b 
b x x x x x x x x x x x x x x x x x x x x x x x b 
b x x x x x x x x x x x x x x x x x x x x x x x b 
b x x x x x x x x x x x x x x x x x x x x x x x b 
b x x x x x x x x x x x x k x x x x x x x x x x b 
b x x x x x x x x x x x e x x x x x x x x x x x b 
b x x x x x x x x x x x x x x x x x x x x x x x b 
b x x x x x x x x x x x x x x x x x x x x x x x b 
b x x x x x x x x x x x x x x x x x x x x x x x b
b x x x x x x x x x x x x x x x x x x x x x x x b 
b x x x x x x x x x x x x x x x x x x x x x x x b
b x x x x x x x x x x x x x x x x x x x x x x x b 
b x x x x x x x x x x x x x x x x x x x x x x x b 
b x x x x x x x x x x x x x x x x x x x x x x x b 
b x x x x x x x x x x x x x x x x x x x x x x x b 
b x x x x x x x x x x x x x x x x x x x x x x x b
b x x x x x x x x x x x x x x x x x x x x x x x b 
b h x x x x x x x x x x x x x x x x x x x x x x b 
b b b b b b b b b b b b b b b b b b b b b b b b b 
